1111111111111
10P0000001011
100001110E011
100011E000011
1111111111111