11111111111
1P00C00E001
11111111111
