1111111111111
1000000001PC1
10E0000CC0011
100011C000011
1000CCCCC1011
100CC1C000011
100C100111011
100011C000011
1111111111111
