11111111111
1PC0000E001
11111111111
